W   P1  H   W   W   W   W
W   W   W   G1  W   W   W
W   W   W   B1  W   W   W
W   G2  B2  .   P1  W   W
W   W   W   B3  W   W   W
W   W   W   G3  W   W   W
W   W   W   W   W   W   W