G1 .  .  .  .
.  .  .  .  .
.  B1 .  B2 H
.  .  .  .  .
G2 .  .  .  .